***X***************
XX*XXX*X*XXXXXXXXX*
*X***X*X***X*****X*
*XXX*XXXXX*X*XXXXX*
*****X*****X*X*****
*XXXXX*XXXXX*X*XXXX
*X*****X***X***X***
*X*XXX*X*X*X*XXX*X*
*X***X*X*X***X***X*
*XXXXX*X*XXXXX*X*XX
*****X*X*****X*X***
XXXX*X*XXXXX*XXXXX*
***X***X***X*******
*XXXXXXX*XXXXXXXXX*
*****X***********X*
*X*XXX*XXX*XXXXX*X*
*X*X***X*X*****X*X*
*X*X*XXX*XXXXX*XXX*
*X***********X*****
