*********X*X*****X*
XXXXXXXX*X*X*X*X*X*
*****X***X*X*X*X***
XXXX*X*XXX*X*X*XXX*
*********X***X*X*X*
*X*XXX*X*X*XXX*X*X*
*X*X***X*****X*X***
*XXX*XXX*XXXXX*XXXX
*********X***X*****
*X*XXXXXXX*X*XXXXX*
***X*****X*X***X***
*XXX*XXX*X*XXX*X*X*
*X***X*X*X***X***X*
*XXX*X*X*XXX*XXXXX*
***X*X***X***X***X*
XX*X*X*XXX*XXX*XXX*
*X***X***X*X*******
*XXXXXXX*X*X*XXXXXX
***********X*******
