*X*******X*******X*
*XXX*XXX*XXX*XXX*X*
***X***X*****X***X*
XX*XXX*XXXXXXX*XXX*
*X***X*X*****X***X*
*XXX*X*X*XXX*XXX*X*
***X***X*X***X***X*
XX*XXXXX*X*XXX*XXX*
*******X*X*****X***
*XXXXXXX*XXXXXXX*XX
***X*****X*****X***
XX*X*XXXXX*X*X*XXX*
***X***X*X*X*X*X***
*XXXXX*X*X*X*X*X*X*
***X***X***X*X*X*X*
*X*X*XXX*XXX*X*X*XX
*X*X***X*X***X*X***
*X*XXX*XXX*XXX*XXX*
*X*********X*******
